1111111111
1000000001
1001001011
1101000001
1001000101
1101111001
1$01000001
1000000001
1111111111