1111111111
10$0000001
1E01001011
1001000E01
1001000101
1101111001
1$0100E001
10000E0001
1111111111